                      |                                                                                              
                      87                                                                                             
                      |                                                                                              
               161--- 74                                                                                             
                      |     |           |                                                                            
---335---188---139--- 65--- 58          0                                                                            
                      |           |     |     |                                                                      
               162--- 67--- 16--- 8     2 --- 3 --- 5                                                                
                            |           |     |                                                                      
                            56--- 7 --- 6     9 --- 11                                                               
                                  |     |     |     |                                                                
                                        21--- 12--- 14--- 37                                                         
                                              |     |     |                                                          
                                              18    34--- 35                                                         
                                              |     |     |                                         |                
                                              22    50    52--- 75--- 85---154---193---251---315   382---388---477---
                                              |     |     |     |     |           |           |                      
                                              78    89    68---100---112---140   217---247---261---322---435         
                                              |     |     |     |           |           |           |                
                                             108--- 93   135---106   141---156---164---298   277---323---433         
                                              |     |           |     |           |     |     |                      
                           214---173---133---117---166---150   111---158   168---340   324---354                     
                                        |     |     |     |     |     |     |           |                            
                                 195---138---131   198---199   367   167---260   356---349---384                     
                                              |     |     |     |     |                 |                            
                                       211   244---239   230---297   262---358---401   352---485                     
                                        |     |     |     |     |     |     |     |     |                            
                                                   321---307---371   370---407   463---362                           
                                                          |     |     |                 |                            
                                                   413   373   475   434   496   468   399                           
                                                    |     |     |     |     |     |     |                            
                                                         480   484                     467                           
                                                          |     |                       |                            
